3, 3, 3, 3, 3, 3, 3, 3, 3, 3
3, 0, 7, 0, 0, 4, 4, 4, 0, 3
3, 0, 0, 0, 0, 0, 6, 4, 4, 3
3, 0, 0, 0, 7, 0, 0, 0, 2, 3
3, 0, 0, 0, 0, 0, 0, 7, 2, 3
3, 3, 3, 3, 3, 3, 3, 3, 3, 3

3, 3, 3, 3, 3, 3, 3, 3, 3, 3, 3, 3
3, 0, 7, 0, 0, 4, 4, 4, 0, 4, 0, 3
3, 0, 0, 0, 0, 0, 6, 4, 4, 4, 4, 3
3, 0, 0, 0, 0, 0, 0, 0, 2, 0, 2, 3
3, 0, 0, 0, 0, 0, 0, 0, 2, 7, 2, 3
3, 0, 0, 0, 0, 0, 0, 0, 0, 0, 2, 3
3, 0, 0, 0, 0, 0, 0, 1, 0, 7, 2, 3
3, 3, 3, 3, 3, 3, 3, 3, 3, 3, 3, 3

3, 3, 3, 3, 3, 3, 3, 3, 3, 3, 3, 3, 3, 3 
3, 0, 7, 0, 0, 0, 0, 0, 0, 0, 0, 0, 0, 3 
3, 0, 5, 0, 0, 0, 6, 0, 0, 10, 0, 0, 0, 3 
3, 0, 0, 0, 0, 0, 0, 0, 0, 0, 0, 0, 0, 3 
3, 0, 0, 0, 0, 0, 0, 0, 0, 7, 0, 7, 0, 3 
3, 0, 0, 0, 0, 0, 0, 0, 0, 0, 0, 0, 0, 3 
3, 0, 0, 0, 0, 0, 0, 0, 0, 0, 7, 7, 0, 3 
3, 0, 0, 0, 0, 0, 0, 0, 0, 0, 0, 0, 0, 3 
3, 0, 0, 0, 0, 0, 0, 0, 0, 7, 7, 0, 0, 3 
3, 3, 3, 3, 3, 3, 3, 3, 3, 3, 3, 3, 3, 3 

3, 3, 3, 3, 3, 3, 3, 3, 3, 3, 3, 3, 3, 3, 3, 3 
3, 0, 7, 0, 0, 0, 0, 0, 0, 8, 0, 0, 0, 0, 0, 3 
3, 0, 5, 0, 0, 0, 6, 0, 0, 0, 0, 0, 0, 0, 0, 3 
3, 0, 0, 0, 0, 0, 0, 0, 0, 0, 0, 0, 0, 0, 0, 3 
3, 0, 0, 0, 0, 0, 0, 0, 0, 0, 0, 0, 0, 0, 0, 3 
3, 0, 0, 0, 0, 0, 7, 0, 0, 0, 0, 0, 0, 0, 0, 3 
3, 0, 0, 0, 0, 0, 7, 0, 0, 0, 0, 0, 0, 0, 0, 3 
3, 0, 0, 0, 0, 0, 7, 0, 0, 0, 0, 0, 0, 0, 0, 3 
3, 0, 0, 0, 0, 0, 0, 0, 0, 0, 0, 0, 0, 0, 1, 3 
3, 3, 3, 3, 3, 3, 3, 3, 3, 3, 3, 3, 3, 3, 3, 3 

3, 3, 3, 3, 3, 3, 3, 3, 3, 3, 3, 3, 3, 3, 3, 3, 3, 3 
3, 0, 7, 0, 0, 0, 0, 0, 0, 0, 0, 0, 0, 0, 0, 0, 0, 3 
3, 6, 11, 0, 0, 0, 0, 0, 0, 0, 0, 0, 0, 0, 11, 0, 0, 3 
3, 0, 0, 0, 0, 0, 0, 0, 0, 0, 0, 0, 0, 0, 0, 7, 0, 3 
3, 0, 0, 0, 0, 0, 0, 0, 0, 0, 0, 0, 0, 0, 0, 0, 0, 3 
3, 0, 0, 0, 0, 0, 0, 0, 0, 0, 0, 0, 0, 0, 0, 7, 0, 3 
3, 0, 0, 0, 0, 0, 0, 0, 0, 0, 0, 0, 0, 0, 0, 0, 0, 3 
3, 0, 0, 0, 0, 0, 0, 0, 0, 0, 0, 0, 0, 0, 11, 0, 0, 3 
3, 0, 0, 0, 0, 0, 0, 0, 0, 0, 0, 0, 0, 0, 0, 0, 0, 3 
3, 0, 0, 0, 0, 0, 0, 0, 0, 0, 0, 0, 0, 0, 0, 0, 0, 3 
3, 0, 0, 1, 0, 0, 0, 0, 0, 0, 0, 0, 0, 0, 0, 0, 0, 3 
3, 3, 3, 3, 3, 3, 3, 3, 3, 3, 3, 3, 3, 3, 3, 3, 3, 3 